0,0,0,0,0,0,0,0,0,0,0,0,0,0,0,0,0,0,0,0,0,0,0,0,0,0,0,0,0,0,0,0,0,0,0,0,0,0,0,0
0,0,0,0,0,0,0,0,0,0,0,0,0,0,0,0,0,0,0,0,0,0,0,0,0,0,0,0,0,0,0,0,0,0,0,0,0,0,0,0
0,0,0,0,0,0,0,0,0,0,0,0,0,0,0,0,0,0,0,0,0,0,0,0,0,0,0,0,0,0,0,0,0,0,0,0,0,0,0,0
0,0,0,0,0,0,0,0,0,0,0,0,0,0,0,0,0,0,0,0,0,0,0,0,0,0,0,0,0,0,0,0,0,0,0,0,0,0,0,0
0,0,0,0,0,0,0,0,0,0,0,0,0,0,0,0,0,0,0,0,0,0,0,0,0,0,0,0,0,0,0,0,0,0,0,0,0,0,0,0
0,0,0,0,0,0,0,0,0,0,0,0,0,0,0,0,0,0,0,0,0,0,0,0,0,0,0,0,0,0,0,0,0,0,0,0,0,0,0,0
0,0,0,0,0,0,0,0,0,0,0,0,0,0,0,0,0,0,0,0,0,0,0,0,0,0,0,0,0,0,0,0,0,0,0,0,0,0,0,0
3,3,3,3,3,3,3,3,0,0,0,3,3,3,3,3,3,3,3,3,0,0,0,0,0,0,0,0,0,0,0,0,0,0,0,0,0,0,0,0
3,3,3,3,3,3,3,3,3,3,2,2,2,2,2,3,3,3,3,3,3,3,3,3,3,0,0,0,0,0,0,0,0,0,0,0,0,0,0,0
3,3,3,3,3,0,0,0,0,0,2,2,0,0,0,0,0,0,0,0,0,0,0,0,0,0,0,0,0,0,0,0,0,0,0,0,0,0,0,0
3,3,3,0,0,0,0,0,0,0,0,0,0,0,0,0,0,0,0,0,0,0,0,0,0,0,0,0,0,0,0,0,0,0,0,0,0,0,0,0
3,3,0,0,0,0,0,0,0,0,0,0,0,0,0,0,0,0,0,0,0,0,0,0,0,0,0,0,0,0,0,0,0,0,0,0,0,0,0,2
3,3,0,0,0,0,0,0,0,0,0,0,0,0,2,2,2,2,2,2,0,0,0,0,0,0,0,0,0,0,0,0,0,0,0,2,2,2,2,2
3,3,3,3,3,0,0,0,0,0,0,0,2,2,2,2,2,2,2,2,3,3,3,3,3,3,3,0,0,0,2,2,2,2,2,2,2,2,2,2
3,3,3,3,3,3,3,3,0,0,0,0,2,2,2,2,2,2,2,2,3,0,0,0,0,0,0,0,0,0,0,0,0,2,2,2,2,2,2,2
3,3,3,3,0,0,0,0,0,0,0,2,2,2,0,2,2,2,2,2,3,0,0,0,0,0,0,0,0,0,0,0,0,0,0,2,2,2,2,2
3,3,0,0,0,0,0,0,0,0,0,0,0,0,0,0,2,2,2,2,0,0,0,0,0,0,0,0,0,0,0,0,0,0,0,0,2,2,2,2
3,3,0,0,0,0,0,0,0,0,0,0,0,0,0,0,2,2,2,2,0,0,0,0,3,3,3,3,0,0,0,0,0,0,0,0,2,2,2,2
3,3,1,0,0,0,0,0,0,0,0,0,0,0,0,0,0,2,2,2,0,0,0,0,3,3,3,3,3,0,0,0,0,0,0,0,0,2,2,2
3,3,0,0,0,0,0,2,2,2,2,2,2,0,0,0,0,0,2,2,0,0,0,0,3,3,3,2,2,2,2,2,2,0,0,0,0,0,0,0
3,3,0,0,0,0,2,2,2,2,2,2,2,2,0,0,0,0,2,2,0,0,0,3,3,3,2,2,2,2,2,2,2,2,0,0,0,0,0,0
3,3,3,3,2,2,2,2,2,2,2,2,2,2,2,0,0,0,2,2,3,3,3,3,2,2,2,2,2,2,2,2,2,2,2,0,0,0,0,0
3,3,3,2,2,2,2,2,2,2,2,2,2,2,2,2,0,0,2,2,3,3,3,2,2,2,2,2,2,2,2,2,2,2,2,2,2,2,2,2
3,3,3,2,2,2,2,2,2,2,2,2,2,2,2,2,2,2,2,2,3,3,3,2,2,2,2,2,2,2,2,2,2,2,2,2,2,2,2,2
1248,608
4
160,128
96,320
640,576
224,512